EA ./textures/wall_1.xpm
SO ./textures/wall_2.xpm
F 70,128,200
WE ./textures/wall_3.xpm
NO ./textures/wall_4.xpm
C 0,255,255

111111111111111111111111111111
1100000000000000000000000000C1
100000000010001000000000000001
100000000001010000000001100001
100000000000100000000001100001
100000000000C00000000000000001
10000000000000000000000000000111111111111111111111111111111111111111111111111111111111111111111111111111111111111111111111111111
10000000000000000000000000000000000000000000000000000000000000000000000000000000000000000000000000000000000000000000000000000001
1000C000000000000000000000000111111111111111111111111111111111111111111111111111111111111111111111111111111111111111111111111111
100C1C000000N0000000001000011
1000C0000000000000000000000011
1000CCCCCCCCCCCCCCCCCCC00C0011
100000000000000000000000000011
100000000000000000000000000011
100000000000000000000000000011
100000000000000000000000000011
100000000000000000000000000011
100000000000000000000000000011
100000000000000000000000000011
100000000000000000000000000011
100000000000000000000000000011
100000000000000000000000000011
100000100000000000000010000011
111111111111111111111111111111
